R 1200 800

NO    greystone.xpm

SO greystone.xpm

WE bluestone.xpm

EA purplestone.xpm

S pillar.xpm

F 245,239,66

C 66,245,215
1 E 1 1 1 1 1 1 1 1 1 1 1 1 1 1 1 1 1 1 1 1 1 1
1 0 0 0 0 0 0 0 0 0 0 0 0 0 0 0 0 0 0 0 0 0 0 1
1 0 0 0 0 0 0 0 0 0 0 0 0 0 0 0 0 0 0 0 0 0 0 1
1 0 0 0 0 0 0 0 0 E N 0 0 2 0 0 0 0 0 2 2 2 0 1
1 0 0 0 0 0 0 0 0 S W 0 0 0 0 0 0 0 0 2 W 2 0 1
1 0 0 0 0 0 0 0 0 0 0 0 0 0 0 0 0 0 0 0 0 0 0 1
1 1 1 1 1 1 1 1 1 1 1 1 1 1 1 1 1 1 1 1 1 1 1 1
