R 1200 800

NO    greystone.xpm

SO greystone.xpm

WE bluestone.xpm

EA purplestone.xpm

S pillar.xpm

F 255,1,6

C 255,214,6
1 E 1 1 1 1 1 1 1 1 1 1 1 1 1 1 1 1 1 1 1 1 1 1
1 0 0 0 0 0 0 0 0 0 0 0 0 0 0 0 0 0 0 0 0 0 0 1
1 0 0 0 0 0 0 0 0 0 0 0 0 0 0 0 0 0 0 0 0 0 0 1
1 0 0 0 0 0 0 0 0 E N 0 0 2 0 0 0 0 0 2 2 2 0 1
1 0 0 0 0 0 0 0 0 S W 0 0 0 0 0 0 0 0 2 W 2 0 1
1 0 0 0 0 0 0 0 0 0 0 0 0 0 0 0 0 0 0 0 0 0 0 1
1 1 1 1 1 1 1 1 1 1 1 1 1 1 1 1 1 1 1 1 1 1 1 1
