R 800 600

NO    bluestone.xpm

SO greystone.xpm

WE greystone.xpm


S pillar.xpm

F 255,0,0

C 117,214,255
1111111111111111111111111111111111111111111111111111111111111111
1000000000000000000000000000000000000000000000000000000000000001
1000000000000000000000000000000000000000000000000000000000000001
1000000000000000000000000000000000000000000000000000000000000001
1000000000000000000000000000000000000000000000000000000000000001
1000000000000000000000000000000000000000000000000000000000000001
1000000000000000000000000000000000000000000000000000000000000001
1000000000000000000000000000000000000000000000000000000000000001
1000000000000000000000000111111111110000000000002220000000000001
100000000000000000000000010000000000000000000000N020000000000001
1000000000000000000000000100011111110000000000000020000000000001
1000000000000000000000000100010000000000000000002220000000000001
1000000000000000000000000100010000000000000000000000000000000001
1000000000000000000000000100010000000000000000000000000000000001
100000000000000000000000010W010000000000000000000000000000000001
1000000000000000000000000100010000000000000000000000000000000001
1111111111111111111111111111111111111111111111111111111111111111
