R 190056465416541651515151 1200

NO    greystone.xpm

SO greystone.xpm

WE bluestone.xpm

EA purplestone.xpm

S pillar.xpm

F 255,1,6

C 117,214,6
11111111111111111111111
10000000000000000000001
100000000000W000000000E
11111111111111111111111
